R 1000 500

NO textures/barrel_wood.xpm
SO textures/barrel_wood.xpm
WE textures/barrel_wood.xpm
EA textures/barrel_wood.xpm
S textures/barrel_wood.xpm

F 3,100,0
C 225,1,0

11111111111111111111111111111
10000000000000000000000000001
10000000000000000000000000001
10000000000000000000000000001
10000000000000000000000000001
10000000000000000000000000001
10000000000000000000000000001
100000000000000N0000000000001
11111111111111111111111111111
