R 1920 1080

NO textures/barrel_wood.xpm
SO textures/barrel_wood.xpm
WE textures/barrel_wood.xpm
EA textures/barrel_wood.xpm
S textures/barrel_wood.xpm

F 42, 45, 52
C 133, 183, 62

11111111111111111111111111111111
10000000000000000000000000000001
10000000000022200000000000000001
10000010000000000000000000000001
10000000010000000001111111000001
10000000010000000000000000000001
10000000000000000000000000000001
100000111100000000000000000N0001
11111111111111111111111111111111
