R 1000 700

NO textures/wolf_wood.xpm
SO textures/wolf_metal.xpm
WE textures/wolf_brick.xpm
EA textures/wolf_grass.xpm
S textures/eye.xpm

C 230, 230, 250
F 105, 105, 105

111111111111
1S0000000001
101111110111
101000000001
101011111101
101010000001
100011011101
101000010111
101101000001
101001111101
100011000001
111111111111
