R 1920 1080

NO textures/wolf_wood.xpm
SO textures/wolf_metal.xpm
WE textures/wolf_brick.xpm
EA textures/wolf_grass.xpm
S textures/eye.xpm

C 230, 230, 250
F 105, 105, 105

11111111111111111111111111111111
10000000000101000000000000000001
10000000000100010001111111111101
10000010000000010000000000000001
10000000010000010001111111000001
10000000010000010000000001000001
10000000000000010000000001000001
100000111100000100000000010N0001
11111111111111111111111111111111
