R 1920 1080

NO textures/wolf_wood.xpm
SO textures/wolf_metal.xpm
WE textures/wolf_brick.xpm
EA textures/wolf_grass.xpm
S textures/eye.xpm

C 230, 230, 250
F 105, 105, 105

11111111111111111111111111111111
10000000000000000000000000000001
10000000000000000000000000000001
10000000000000000000000000000001
10000020000000000000000200000001
10000000000000000000000000000001
10000000000000000000000000000001
10000000000000000000000000000001
100000000000000000000N0000000001
11111111111111111111111111111111
