R 1000 700

NO textures/wolf_wood.xpm
SO textures/wolf_metal.xpm
WE textures/wolf_brick.xpm
EA textures/wolf_grass.xpm
S textures/eye.xpm

C 230, 230, 250
F 105, 105, 105

111111111111111111111111111111111111111111111
100000000000000001210000000000000000100000001
100000000000000001010000000000000000100000001
100000000000000001010000010111100010100110101
100000000000000001010000010100000010100110101
100000000222000000000011110100000011111110001
100000000000000000000000000100000000000110101
100000000000000000000000000000000000000110101
100000000000000000000000011100000000000110101
100000000000000000000000010111111111000000101
1000000000000000000000000100000000000011000N1
111111111111111111111111111111111111111111111
